300000000000000000000000000000000000000000000000000000000000000000000000000000000000000000000000000000000000000000000000000000000000000000000000000000000000000000000000000000000000000000000000000000000000000000000
300000333333333333333333333333333333333333333333333333333333333333333333333333333333333333333333333333333333333333333333333333333333333333333333333333333333333333333333333333333333333333333300000000000000000000000
300000000000000000000000000000000000000000000000000000330033333300333300000033330000000000000000000000000000000000000000000000000000000000000000000000000000000000000000000000000000000000000000000000000000000000000
300000000000000000000000000000000000000000000000000000330033333300333300000033330000000000000000000000000000000000000000000000000000000000000000000000000000000000000000000000000000000000000000000000000000000000000
300000000000000000000000000000000000000000000000000033000000003300030000330000000000000000000000000000000000000000000000000000000000000000000000000000000000000000000000000000000000000000005500000000000000000000000
300000000000000000000000000000000000000000000000000033000000003300030000330000000000000000000000000000000000000000000000000000000000000000000000000000000000000000000000000000000000000000055500000000000000000000000
300000000000000000000000000000000000000303333030000033000000003300030000330000000000333333000000000000000000000000000000000000000000000000000000000000000000000000000000000000000000000000555500000000000000000000000
300000000000000000000000000003000000000303003030000033000000003300030300330000000000333333000000000000000000000000000000000000000000000000000000000000000000000000000000000000000000000005555500000000000000000000000
300000000011111000000005050000000000000333003330000033330033333300033300330033330000000000000000000000000000000000000000000000000000000055000000000000055005000000000000331300000000000055555500000000000000000000000
300000000000000000000505050500050000000000000000000000330000000000000000000000000000000000000000000000000000000000000000003300000000000555000000000000555005500000000000000000000000000555555500000000000000000000000
300000000000000000050505050500050500000000000000000000330000000000000000000000000000000000000000000000000000000000000000003300000000005555000000000005555005550000000000000000000000005555555500000000000000000000000
300000000000000005050505050500050500000000000000000000000000000000000000000000000000000000000000000000000000000000000000003300000000055555000000000055555005555000000000000000000000055555555500000000500000000000000
444444444444444444444444444444444444444444444444444444444444444444444444444444440004444444444444444444444444444444444444004400444444444444444444444444444004444444444444444444444444444444444444444444444444444444444