000000000000000000000000000000000000000000000000000000000000000000000000000000000000000000000000000000000000000000000000000000000000000000000000000000000000000000000000000000000000000000000000000000000000000000000
000000000000000000000000000000000000000000000000000000000000000000000000000000000000000000000000000000000000000000000000000000000000000000000000000000000000000000000000000000000000000000000000000000000000000000000
000000000000000000000000000000000000000000000000000000000000000000000000000000000000000000000000000000000000000000000000000000000000000000000000000000000000000000000000000000000000000000000000000000000000000000000
000000000000000000000000000000000000000000000000000000000000000000000000000000007000070000000000000000000000000000000000000000000000000000000000000000000000000000000000000000000000000000000000000000000000000000000
000000000000000000000010000000000000000000000000000000000000000000000000000000003333333300033310000000000000010000000000033300003113000000000000000000000000000000000000000000000000000000005500000000000000000000000
000000000000000000000000000000000000000000000000000000000000000000000000000000000000000000000000000000000000000000000000000000000000000007000000000000007000000000000000000000000000000000055500000000000000000000000
000000000000000000000000000000000000000000000000000000000000000000000000000000000000000000000000000000000000000000000000000000000000000000000000000000000000000000000000000000000000000000555500000000000000000000000
000000000000000000000000000000000000000000000000000000000000000000000000000000000000000000000000000000000000000000000000000000000000000000000000000000000000000000000000000000000000000005555500000000000000000000000
000000000000000010003131300000000000000000000066000000000660000000000000000003130000000000000030000033000010010010000030000000000330000005005000000000055005000000000000331300000000000055555500000000000000000000000
000000000000000000000000000000000000006600000066000000000660000000000000000000000000000000000000000000000000000000000000000000000000000055005500000000555005500000000000000000000000000555555500000000000000000000000
000000000000000000000000000066000000006600000066000000000660000000000000000000000000000000000000000000000000000000000000000000000000000555005550000005555005550000066000000000000006605555555500000000000000000000000
000000000000000000000000070066000080006600000766000007070660000000000000000000000000000000000000007070000008000000000000070700070700005555005555000055555005555000066000007070000006655555555500000000500000000000000
444444444444444444444444444444444444444444444444444444444444444444444004444444444444440004444444444444444444444444444444444444444444444444444444444444444004444444444444444444444444444444444444444444444444444444444