000000000000000000000000000000000000000000000000000000000000000000000000000000000000000005000000000000000000000000000000000000000000000000000000000000000000000000000000000000000000000000000000000000000000000000000
000000000000000000000000000000000000000000000000000000000000000000000000000000000000000005000000000000000000000000000000000000000000000000000000000000000000000000000000000000000000000000000000000000000000000000000
000000000000000000000000000000000000000000000000000000000000000000000000000000000000000005000000000000000000000000000000000000000000000000000000000000000000000000000000000000000000000000000000000000000000000000000
000000000000000000000000000000000000000000000000000000000000000000000000000000000000000005000000000000000000000000000000000000000000000000000000000000000000000000000000000000000000000000000000000000000000000000000
000000000000000010000000011100000000000000000000000000000000000003355555000000000000000005000000000000000000000000300000000000000000000000000000000000000000000000000000000000000000000000005500000000000000000000000
000000000000000000000000000000000000000000000000000000000000000033000005333333330000000005000000000000000000000003000000000000000000000000000000000000000000000000000000000000000000000000055500000000000000000000000
000000000000000000000000000000000000000000000000000000000000000330000005000000055555555555000000000000000000000030000000000000000000000000000000000000000000000000000000000000000000000000555500000000000000000000000
000000000000000000000000000000000000000000000000000000000000000000000005000000000000000005000000000000000000000300000000000000000000000000000000000000000000000000000000000000000000000005555500000000000000000000000
000000000000000313000000000000000000000000000066000000000660000000010005000000000000000005000000000000000000003001000000000000000000000000000000000313000000000000000000000000000000000055555500000000000000000000000
000000000000000000000000000000000000006600000066000000000660000000000005555555555555500003000000000000000000030000000000000000000000000000000000000000000000000000000000000000000000000555555500000000000000000000000
000000000000000000000000000066000000006600000066000000000660000000000003000000000000000003000000000000000000300000000000000000000000000000055000000000000000000000066000000000000006605555555500000000000000000000000
000000000000000000000000000066000000006600000066000000000660000000000003000000000000000003000000000000000003000000000000000000000000000000055000000000000005000000066000000000000006655555555500000000500000000000000
444444444444444444444444444444444444444444444444444444444444444444444004444444444444444444444444444444444444444444444444444444444444444444444444444444444004444444444444444444444444444444444444444444444444444444444