000000000000000000000000000000000000000000000000000000000000000000000000000000000000000005000000000000000000000000000000000000000000000000000000000000000000000000000000000000000000000000000000000000000000000000000
000000000000000000000000000000000000000000000000000000000000000000000000000000000000000005000000000000000000000000000000000000000000000000000000000000000000000000000000000000000000000000000000000000000000000000000
000000000000000000000000000000000000000000000000000000000000000000000000000000000000000005000000000000000000000000800000000000000000000000000000000000000000000000000000000000000000000000000000000000000000000000000
000000000000000000000000007000000000000000000000000000000000000000000000000000000000000005000000000000000000000000700000000000000000000000000000000000000000000000000000000000000000000000000000000000000000000000000
000000000000000010000000011100000000000000000000000000000000000001155555000008000000000005000000000000000000000007300000070000000000000707000000000000000000000000000000000000000000000000005500000000000000000000000
000000000000000000000000000000000000000000000000000000000000000011000005333333333300708705000000000000000000000073000000000000000000000000000000000000000000000000000000000000000000000000055500000000000000000000000
000000000000000000000000000000000000000000000000000000000000000110000005000000055555555555000000000000000000000730000000000700000000000000000000000000000000000000000000000000000000000000555500000000000000000000000
000000000000000000000000000000000000000000000000000000000000000000070005000000000000000005000000000000000000007300000007000000008000800000000000000070000000000000066000000000000000000005555500000000000000000000000
000000000000000313000000000000000000000000000066000000000660000000030005000000000000000005000000000000000000073001000000000008000000000000000000000313000000000000066000000000000000000055555500000000000000000000000
000000000000000000000000000000000000006600000066000000000660000000000005555555555555500003000000000000000000730000000008000000000000000000000000000000000000000000066000000000000000000555555500000000000000000000000
000000000000000000000000000066000000006600000066000000000660000000000003000000000000000003000000000000000007300000700000000000000007000000055000000000000000000000066000000000000006605555555500000000000000000000000
000000000000000000000000000066000000706600000066000070000660000000000003000007000000000003000000000000000073000000000000000000000000000000055000000000000005000080066000000000000706655555555500000000500000000000000
444444444444444444444444444444444444444444444444444444444444444444444004444444444444444444444444444444444444444444444444444444444444444444444444444444444004444444444444444444444444444444444444444444444444444444444